上鏈	上鍊
仿佛	彷彿
彷徨	彷徨
手鏈	手鍊
拉鏈	拉鍊
拉鏈工程	拉鍊工程
於世成	於世成
於乎	於乎
於仲完	於仲完
於倫	於倫
於其一	於其一
於則	於則
於勇明	於勇明
於呼哀哉	於呼哀哉
於單	於單
於坦	於坦
於崇文	於崇文
於忠祥	於忠祥
於惟一	於惟一
於戲	於戲
於敖	於敖
於梨華	於梨華
於清言	於清言
於琳	於琳
於穆	於穆
於竹屋	於竹屋
於菟	於菟
於邑	於邑
於陵子	於陵子
李鏈福	李鍊福
樊於期	樊於期
珍珠項鏈	珍珠項鍊
瞭然于心	瞭然於心
肘手鏈足	肘手鍊足
藉助于	藉助於
金鏈	金鍊
鉸鏈	鉸鍊
銀鏈	銀鍊
鏈墜	鍊墜
鏈子	鍊子
鏈形	鍊形
鏈條	鍊條
鏈錘	鍊錘
鏈鎖	鍊鎖
鎖鏈	鎖鍊
鐵鏈	鐵鍊
鑽石項鏈	鑽石項鍊
項鏈	項鍊
頸鏈	頸鍊
